Wednesday, 17 May 2006

Parliament met at 10.00 a.m. at Parliament House, Kampala.
(The Clerk to Parliament, Mr A.M. Tandekwire, presiding)

NATIONAL ANTHEM (One Stanza)

PRAYERS

PROCLAMATION

CLERK ASSISTANT: Whereas the Electoral Commission has organised and conducted the elections of all the Constituency Members of Parliament and the elections of all the representatives in Parliament of the Special interest groups specified in Article 78 of the Constitution;

And whereas the Electoral Commission has ascertained, declared in writing under its seal and published in the Gazette the results of the election in each Constituency and each interest group, which results have been availed to the Clerk to Parliament;

And whereas Article 81 Clause 4 of the Constitution of the Republic of Uganda stipulates that every person elected to Parliament shall take and subscribe the Oath of Allegiance and the Oath of Member of Parliament specified in the Fourth Schedule of the Constitution;

And whereas Clause 5 of the same Article further stipulates that except for the purpose of taking the Oaths referred to in Clause 4 no person shall sit or vote in Parliament before taking and subscribing the oaths;

And whereas under the Oaths Act, Second Schedule, Chapter 52 of the Laws of Uganda, the Clerk to Parliament is mandated to tender the Oath of Allegiance and the Oath of Member of Parliament to Members-Elect before they elect their Speaker.

Now therefore by the powers conferred to him by the said law, the Clerk to Parliament will now proceed to administer the Oath of Allegiance and the Oath of Member of Parliament to each Member-Elect.

ADMINISTRATION OF OATHS

The Oaths were administered to:

1. AKELLO JUDITH FRANCA	PADER	FDC	DISTRICT WOMAN REP.
2. ANYWAR ATIM O. BEATRICE	KITGUM	FDC	DISTRICT WOMAN REP.
3. AOL BETTY OCAN	GULU	FDC	DISTRICT WOMAN REP.
4.  MABIKKE MICHAEL	KAMPALA	INDPT	MAKINDYE DIVISION EAST
5. MADADA KYEBAKOZE S.	KAYUNGA	NRM	BBALE COUNTY
6. MAGOOLA ZIRABAMUZAALE B.	IGANGA	NRM	DISTRICT WOMAN REP.
7. MAGULUMAALI MUGUMYA E.	RAKAI	INDPT 	KOOKI COUNTY
8. MAKUMBI JAMES DR (BRIG.)			UPDF REPRESENTATIVE
9. MALINGA JOHNSON	AMURIA	INDPT	KAPELEBYONG
10. MALLINGA STEPHEN OSCAR	PALLISA	NRM	BUTEBO COUNTY
11. MASIKO WINIFRED KOMUHANGI	RUKUNGIRI	NRM	DISTRICT WOMAN REP.
12. MATTE JOSEPH SIBALINGHANA	BUNDIBUGYO	NRM	BUGHENDERA COUNTY
13. MBAGADHI FREDERICK NKAYI	JINJA	NRM	KAGOMA COUNTY
14. MENHYA GERALD SIMON	KAMULI	NRM	BUGABULA COUNTY NORTH
15. MIGEREKO DAUDI	JINJA	NRM	BUTEMBE COUNTY
16. MPABWA SARAH (CAPT.)			UPDF REPRESENTATIVE
17. MUGAMBE JOSEPH KIFOMUSANA	MUKONO	NRM	NAKIFUMA COUNTY
18. MUGARRA, KABAGAMBE F.	BUNDIBUGYO	NRM	NTOROKO COUNTY
19. MUGISA MUHANGA MARGARET	KABAROLE	NRM	DISTRICT WOMAN REP.
20. MUHWEZI JIM KATUGUGU	RUKUNGIRI	NRM	RUJUMBURA COUNTY
21. MUJUZI PIUS	RAKAI	NRM	KYOTERA COUNTY
22. MUKASA ANTHONY HARRIS	MUKONO	NRM	BUIKWE COUNTY SOUTH
23. MUKAYE WABUDEYA BEATRICE	SIRONKO	NRM	DISTRICT WOMAN REP.
24. MUKISA FRED DOUGLAS M.	BUGIRI	NRM	BUKOOLI CENTRAL
25. MUKITALE BIRAAHWA S. A.	MASINDI	NRM	BULIISA COUNTY
26. MUKWAYA BALUNZI JANAT	MUKONO	NRM	MUKONO COUNTY SOUTH
27. MULUMBA MEDDIE B.	IGANGA	NRM	LUUKA COUNTY
28. MUNYIRA WABWIRE ROSE O.	BUSIA	NRM	DISTRICT WOMAN REP.
29. MUSEVENI JANET KATAHA	NTUNGAMO	NRM	RUHAAMA COUNTY
30. MUKOSE MOSES MUTABAALI	IGANGA	NRM	BUSIKI COUNTY
31. MUSUMBA ISAAC ISANGA	KAMULI	NRM	BUZAAYA
32. MUTAGAMBA MARIA LUBEGA E.	RAKAI	NRM	DISTRICT WOMAN REP.
33. MUTULUUZA PETER CLAVERI B.	MPIGI	NRM	MAWOKOTA COUNTY NORTH
34. MUWULIZE NORMAN IBRAHIM	MUKONO	INDPT	BUIKWE COUNTY WEST
35. MUWUMA MILTON KALULU	IGANGA	NRM	KIGULU COUNTY SOUTH
36. MWESIGE ADOLF	KABAROLE	NRM	BUNYANGABU COUNTY
37. MWESIGYE RUHINDI HOPE K.		NRM	DISTRICT WOMAN REP.
38. NAJJEMBA ROSEMARY MUYINDA	MPIGI	NRM	GOMBA COUNTY
39. NAJJUMA FARIDAH KASASA	MUBENDE	NRM	DISTRICT WOMAN REP.
40. NAKADAMA LUKIA	MAYUGE	NRM	DISTRICT WOMAN REP.
41. NAKAWUKI SUSAN	WAKISO	FDC	BUSIRO COUNTY EAST
42. NAKWANG CHRISTINE TUBBO	KAABONG	NRM	DISTRICT WOMAN REP.
43. NALUBEGA MARIAM		INDPT	FEMALE YOUTH REP.
44. NALUGO SEKIZIYIVU MARY M.	MUKONO	NRM	DISTRICT WOMAN REP.
45. NALULE SAFIA		NRM	PWD FEMALE REP.
46. NAMAYANJA ROSE NSEREKO	NAKASEKE	NRM	DISTRICT WOMAN REP.
47. NAMIREMBE G. BITAMAZIRE	MPIGI	NRM	DISTRICT WOMAN REP.
48. NAMOE STELLA NYOMERA	MOROTO	NRM	DISTRICT WOMAN REP.
49. NAMPIJJA LUKYAMUZI SUSAN	KAMPALA	CP	RUBAGA DIVISION SOUTH
50. NAMUYANGU KACHA JENNIPHER	PALLISA	NRM	DISTRICT WOMAN REP.
51. NANDALA MAFABI NATHAN	SIRONKO	FDC	BUDADIRI COUNTY WEST
52. NANKABIRWA RUTH SENTAMU	KIBOGA	NRM	DISTRICT WOMAN REP.
53. NASASIRA JOHN MWOONO K.		NRM	KAZO COUNTY
54. NAYIGA FLORENCE SSEKABIRA	KAYUNGA	NRM	DISTRICT WOMAN REP.
55. NDAWULA EDWARD M. KAWEESI	KIBOGA	NRM	KIBOGA COUNTY WEST
56. NDEEZI ALEX		NRM	PWD CENTRAL REGION
57. NDUHUURA R. BARUGAHARE	BUSHENYI	NRM	IGARA COUNTY EAST
58. NGABIRANO CHARLES	MBARARA	NRM	RWAMPARA COUNTY
59. NIWAGABA WILFRED	KABALE	NRM	NDORWA COUNTY EAST
60.	NJUBA KALEGA SAMUEL	WAKISO	FDC	KYADONDO COUNTY EAST
61. NOKRACH WILSON WILLIAM		NRM	PWD NORTHTERN REGION
62. NSUBUGA WILLIAM	MUKONO	NRM	BUVUMA COUNTY (ISLANDS)
63. NYANZI VINCENT	MITYANA	NRM	BUSUJJU COUNTY
64. NYEKO OCULA MICHAEL	GULU	FDC	KILAK COUNTY
65. NYOMBI NANSUBUGA SARAH	KAYUNGA	NRM	NTENJERU COUNTY NORTH
66. NYOMBI PETER	NAKASONGOLA	INDPT	NAKASONGOLA COUNTY
67. NYOMBI THEMBO G.W.	MUBENDE	NRM	KASSANDA COUNTY SOUTH
68. OBUA DENIS HAMSON		NRM	YOUTH REP., NORTHERN
69. OBUA-OGWAL BENSON	LIRA	UPC	MOROTO COUNTY
70. OBURU GRACE	TORORO	NRM	DISTRICT WOMAN REP.
71. OCENG D. ALEX PENYTOO	GULU	FDC	GULU MUNICIPAL COUNCIL
72. OCHIENG PETER PATRICK	BUGIRI	NRM	BUKOOLI SOUTH
73. ODIT JOHN	LIRA	UPC	ERUTE COUNTY SOUTH
74. ODONGA SAMUEL OTTO	PADER	FDC	ARUU COUNTY
75. ODUMAN ALBERT C. OKELLO	KUMI	FDC	BUKEDEA COUNTY
76. OGENGA LATIGOMORRIS W.	PADER	FDC	AGAGO COUNTY
77. OGWANG JOHN	APAC	UPC	KOLE COUNTY
78. OGWEL LOOTE SAMMY	MOROTO	INDPT	MOROTO MUNICIPALITY
79. OJOK B’LEO	AMOLATAR	INDPT	KIOGA COUNTY
80. OJWOK OMWONY	KOTIDO	NRM	LABWOR COUNTY
81. OKECHO WILLIAM	TORORO	INDPT	WEST BUDAMA CTY NORTH
82. OKELLO FRANCIS  (BRIG.)			UPDF REPRESENTATIVE
83. OKELLO OKELLO J. LIVINGSTONE	KITGUM	UPC	CHUA COUNTY
84. OKETTA JULIUS FACKI (MAJ. GEN.)		UPDF REPRESENTATIVE
85. OKORIMOE JANET G. AKECH	KOTIDO	NRM	DISTRICT WOMAN REP.
86. OKOT OGONG FELIX	LIRA	NRM	DOKOLO COUNTY
87. OKULO EPAK YEFUSA	APAC	INDPT	OYAM COUNTY SOUTH
88. OKUMU RONALD REAGAN	GULU	FDC	ASWA COUNTY
89. OKUPA ELIJAH	SOROTI	FDC	KASILO COUNTY
90. OLEGA ASHRAF NOAH	YUMBE	NRM	ARINGA COUNTY
91. OLENY CHARLES OJOK	KATAKWI	INDPT	USUK COUNTY
92. OLERU HUDA	YUMBE	INDPT	DISTRICT WOMAN REP.
93. OMOLO PETER	SOROTI	FDC	SOROTI COUNTY
94. ONEK OBALOKER HILARY	KITGUM	NRM	LAMWO COUNTY
95. OPANGE LOUIS	PALLISA	INDPT	PALLISA COUNTY
96. OPIO GABRIEL	BUSIA	NRM	SAMIA BUGWE  CTY SOUTH
97. OTAFIIRE KAHINDA (MAJ. GEN)	BUSHENYI	NRM	RUHINDA COUNTY
98. OTEKAT JOHN EMILLY	SOROTI	INDPT	SERERE COUNTY
99. OTIAM OTAALA EMMANUEL	TORORO	NRM	WEST BUDAMA CTY SOUTH
100. OWOR AMOOTI OTADA	MASINDI	NRM	KIBANDA CTY
101. OYET SIMON	GULU	FDC	NWOYA COUNTY

(The Proceedings were suspended until 2.30 p.m. the same day)

(On resumption)

PROCLAMATION

CLERK ASSISTANT: Whereas the Electoral Commission has organised and conducted the elections of all the Constituency Members of Parliament and the elections of all the representatives in Parliament of the Special interest groups specified in Article 78 of the Constitution;

And whereas the Electoral Commission has ascertained, declared in writing under its seal and published in the Gazette the results of the election in each Constituency and each interest group, which results have been availed to the Clerk to Parliament;

And whereas Article 81 Clause 4 of the Constitution of the Republic of Uganda stipulates that every person elected to Parliament shall take and subscribe the Oath of Allegiance and the Oath of Member of Parliament specified in the Fourth Schedule of the Constitution;

And whereas Clause 5 of the same Article further stipulates that except for the purpose of taking the Oaths referred to in Clause 4 no person shall sit or vote in Parliament before taking and subscribing the oaths;

And whereas under the Oaths Act, Second Schedule, Chapter 52 of the Laws of Uganda, the Clerk to Parliament is mandated to tender the Oath of Allegiance and the Oath of Member of Parliament to Members-Elect before they elect their Speaker.

Now therefore by the powers conferred to him by the said law, the Clerk to Parliament will now proceed to administer the Oath of Allegiance and the Oath of Member of Parliament to each Member-Elect.

ADMINISTRATION OF OATHS

The Oaths were administered to:

102. KALIBA STEVEN	KABAROLE	NRM	FORT PORTAL MUNICIPALITY
103. MUGYENYI R. MARY	KIRUHURA	NRM	NYABUSHOZI COUNTY
104. PAJOBO JORAM BRUNO		NRM	WORKERS’ REPRESENTATIVE
105. PIRO SANTOS ERUAGA	ADJUMANI	INDPT	EAST MOYO
106. RINGE CHAN DAVID	NEBBI	UPC	PADYERE COUNTY
107. RUHINDI FREDDIE	KAMPALA	NRM	NAKAWA DIVISION
108. RUKUNDO SERAPIO	KABALE	NRM	KABALE MUNICIPALITY
109. RUKUTANA MWESIGWA	NTUNGAMO	NRM	RUSHENYI COUNTY
110. RWAKIMARI BEATRICE	NTUNGAMO	NRM	DISTRICT WOMAN REP.
111. RWAMIRAMA K. BRIGHT	ISINGIRO	NRM	ISINGIRO COUNTY NORTH 
112. SABILA HERBERT KAALE	KAPCHORWA	NRM	TINGEY COUNTY
113. SEBAGGALA ABDLATIF S.	KAMPALA	DP	KAWEMPE DIVISION NORTH
114. SEBULIBA M. RICHARD	KAMPALA	DP	KAWEMPE DIVISION SOUTH
115. SEJJOBA ISAAC	MASAKA	INDPT	BUKOTO MID-WEST
116. SEKITOLEKO KABONESA J. K. 	KIBAALE	NRM	DISTRICT WOMAN REP.
117. SEKYANZI NDAWULA ALI	LUWEERO	NRM	BAMUNANIKA COUNTY
118. SEMPALA NAGGAYI NABILAH	KAMPALA	FDC	DISTRICT WOMAN REP.
119. SENINDE ROSEMARY N.	WAKISO	NRM	DISTRICT WOMAN REP.
120. SERUNJOGI LASTUS KATENDE	KIBOGA	NRM	KIBOGA COUNTY EAST
121. SSALABAYA HARUUNA	MUBENDE	NRM	KASSANDA COUNTY NORTH
122. SSEKANDI EDWARD KIWANUKA	MASAKA	NRM	BUKOTO CENTRAL
123. SSEKIKUBO THEODORE	SSEMBABULE	NRM	LWEMIYAGA COUNTY
124. SSENTONGO NABULYA T.		NRM	WORKERS’ REP.
125. SSERUNJOGI JAMES MUKIIBI	MASAKA	INDPT	KALUNGU EAST
126. SSINABULYA SYLVIA N.	MITYANA	NRM	DISTRICT WOMAN REP.
127. TANNA SANJAY	TORORO	INDPT	TORORO MUNICIPALITY
128. TASHOBYA N. STEPHEN	NTUNGAMO	NRM	KAJARA COUNTY
129. TETE CHELANGAT EVERLINE	BUKWO	NRM	DISTRICT WOMAN REP.
130. TIBAMANYA URBAN P.K.	MBARARA	NRM	KASHARI COUNTY
131. TINDAMANYIRE KABONDO G.	BUSHENYI	NRM	BUNYARUGURU COUNTY
132. TINKASIIMIRE BARNABAS K.		NRM	BUYAGA COUNTY
133. TINYEFUZA DAVID (GEN.)			UPDF REP.
134. TOOLIT SIMON AKECHA	GULU	FDC	OMORO COUNTY
135. TUBWITA GRACE B. BUKENYA	NAKASONGOLA	NRM	DISTRICT WOMAN REP.
136. TUMA RUTH	JINJA	NRM	DISTRICT WOMAN REP.
137. TUMWEBAZE K. FRANK	KAMWENGE	NRM	KIBALE COUNTY
138. TUMWESIGYE ELIODA	BUSHENYI	NRM	SHEEMA COUNTY NORTH
139. TUMWINE ELLY T. (GEN.)			UPDF REPRESENTATIVE
140. TURYAHIKAYO KEBIRUNGI M. 	RUKUNGIRI	NRM	RUBABO COUNTY
141. TUUNDE MARY M. NALUBEGA		NRM	WORKERS’ FEMALE REP.
142. WACHA BEN	APAC	INDPT	OYAM COUNTY NORTH
143. WADRI KASSIANO EZATI	ARUA	FDC	TEREGO COUNTY
144. WAKIKONA W. DAVID	MANAFWA	NRM	MANJIYA COUNTY
145. WAMAKUYU MUDIMI	SIRONKO	NRM	BULAMBULI COUNTY
146. WAMBUZI NELSON G.	KALIRO	NRM	BULAMOGI
147. WANGWA RUTANGYE N. E.	MBALE	NRM	DISTRICT WOMAN REP.
148. WASIKE STEPHEN MUGENI	BUSIA	NRM	SAMIA BUGWE CTY NORTH
149. WOPUWA GEORGE WILLIAM	MANAFWA	NRM	BUBULO COUNTY EAST
150. YIGA ANTHONY	MASAKA	NRM	KALUNGU WEST

(The House rose at 6.20 p.m. and adjourned until Wednesday, 17th May 2006 at 10.00 a.m.)


